1111111111111111111111111111111
1000002022222220020000200200001
1010101010101010101212101010101
1200000000020002022220200000001
1010101010121010101210121010101
1000000000020000000200202002001
1010101012101010101012101010121
1200020000000000002020020020001
1010101010101010121012121210101
1000000220000000000000220002021
1012101010101012101010101210101
1000000002000000000200000000001
1111111111111111111111111111111