1111111111111111111111111111111
1000002022222220020400200200001
1010101010101010101212101010101
1200000000020002022220200000001
1010131010121010101210121010101
1000000000020004000200202002031
1010101012101010110012101010121
1200020000000000002320020020001
1010101010101010121012121210101
1000000220000004000000220002021
1012101010101012101010101210101
1300000002000000000200000400001
1111111111111111111111111111111