1111111111111111111111111111111
1000002022222220020040200200001
1010101010101010101212101010101
1200000000020002022220200000031
1010101310121010101210121010101
1000040000020300400200202002001
1010101012101010101012101010121
1200020000000000002020020020001
1310101010101010121012121210101
1000030220000000400300220002021
1012101010101012101010101210101
1000000002000000000200000000001
1111111111111111111111111111111